################################
#\                             #
# # # # # # # # # # # # # # # ##
#                              #
# # # # # # # # # # # # # # # ##
#                              #
# # # # # # # # # # # # # # # ##
#                              #
# # # # # # # # # # # # # # # ##
#                              #
# # # # # # # # # # # # # # # ##
#                              #
# # # # # # # # # # # # # # # ##
#                              #
# # # # # # # # # # # # # # # ##
#              = =             #
# # # # # # # # # # # # # # # ##
#              = =             #
# # # # # # # # # # # # # # # ##
#                              #
# # # # # # # # # # # # # # # ##
#                              #
# # # # # # # # # # # # # # # ##
#                              #
# # # # # # # # # # # # # # # ##
#                              #
# # # # # # # # # # # # # # # ##
#                          .   #
# # # # # # # # # # # # # # # ##
#                            % #
# # # # # # # # # # # # # # # ##
################################
