################################
#\.............................#
#.#.#.#.#.#.#.#.#.#.#.#.#.#.#.##
#..............................#
#.#.#.#.#.#.#.#.#.#.#.#.#.#.#.##
#..............................#
#.#.#.#.#.#.#.#.#.#.#.#.#.#.#.##
#..............................#
#.#.#.#.#.#.#.#.#.#.#.#.#.#.#.##
#..............................#
#.#.#.#.#.#.#.#.#.#.#.#.#.#.#.##
#..............................#
#.#.#.#.#.#.#.#.#.#.#.#.#.#.#.##
#..............................#
#.#.#.#.#.#.#.#.#.#.#.#.#.#.#.##
#..............=.=.............#
#.#.#.#.#.#.#.#.#.#.#.#.#.#.#.##
#..............=.=.............#
#.#.#.#.#.#.#.#.#.#.#.#.#.#.#.##
#..............................#
#.#.#.#.#.#.#.#.#.#.#.#.#.#.#.##
#..............................#
#.#.#.#.#.#.#.#.#.#.#.#.#.#.#.##
#..............................#
#.#.#.#.#.#.#.#.#.#.#.#.#.#.#.##
#..............................#
#.#.#.#.#.#.#.#.#.#.#.#.#.#.#.##
#..............................#
#.#.#.#.#.#.#.#.#.#.#.#.#.#.#.##
#............................%.#
#.#.#.#.#.#.#.#.#.#.#.#.#.#.#.##
################################
